#################################################################
###########                              ########################
########### ############################                    #####
########### ############################ ########################
########### ###########    ############# ########################
########### ########### ## ##         #                ##########
########### ########### ## ## ###################### ############
########### ##############    ##                       ##########
########### ################# ## ##################### ##########
########### #######           ## ##################### ##########
########### ####### ############                     # ##########
#######        #### ################################ # ##########
####### ###### #### ##############                   # ##########
####### ##     #### ############## ################### ##########
####### ########### ############## ##############################
A                   ##############    B##########################
############# ######################## ##########################
##          # ######################## ##########################
########### # ######################## ##########################
###         # ######                   ##########################
########### # ###### ################# ##########################
#           # ###### ################# ##########################
# ########### #######################  ##########################
#                                     ###########################
#################################################################