# # # # # # # # # #
# # # # # # # # # #
# # # # # # # # # #
# # # # # # # # # #
# # # # # # # A # #
# # # # # # #   # #
# # # # # B #   # #
# # # # #       # #
# # # # #         #
# # # # #       # #
